22222222222222222
20000000000000002
20202020202020202
20000000000000002
20202020202020202
20000000000000002
20202020202020202
20000000000000002
20202020202020202
20000000000000002
20202020202020202
20000000000000002
22222222222222222
