22222222222222222
20000000000000002
20101010101010102
20000000000000002
20101010101010102
20000000000000002
20101010101010102
20000000000000002
20101010101010102
20000000000000002
20101010101010102
20000000000000002
22222222222222222